10.o
o..o......
....o.....
...o.o....
...o...oo.
oo........
o....oo...
....oo.o..
..........
o.o..o.o.o
o..o..o.o.
