10.ox
.........
..........
.o.o......
o....o....
..........
...ooo....
........oo
..oo......
....o....o
.......o..
