10.oxx
...o......
..o.....o.
...o.....o
...o.o....
....o..o.o
o........o
o.........
o.........
o...oo....
.........o
