9.o
oo.o.o.o.
o........
.....o.o.
.......o.
.......o.
oooo..o..
...oo..o.
...oo....
.o.o.....
...o.o...
