10.oxo....
.....o....
......o...
..........
..........
..........
...o......
..........
.o........
..........
