10.ox
.........o
...o....o.
.....oo..o
o..o..o...
.o.....o..
.o.o.....o
..o.......
..ooo.....
o...oo....
.oo.o..o.o
