20.ox
ooo.o..ooo.......ooo
...o.o..oo..o......o
.....oo.o....oo..ooo
..ooooo.oo.......o..
oo.o...o.o...o..o..o
......o.oo....oo....
.o....o...o.........
..o..o..oo.oo.o...oo
oo..o..........ooo.o
........o...oo...o.o
..o.oo....o.o.o.oo..
...oo...o.....o.o.o.
.oo.o.....o.o...oo..
....o.....o..o....o.
..o..o..oooo..oooo..
oo....o...o..o.o.ooo
.o....o..o..o.oo...o
.....ooo.o....oo.ooo
o.ooo....oo.........
..o.oooo...o.o.....o
